NO ./textures/wolf3D/wood.xpm
R 					800 600
F 122,122,122
SO ./textures/wolf3D/greystone.xpm
WE ./textures/wolf3D/redbrick.xpm
EA ./textures/wolf3D/purplestone.xpm
S ./textures/wolf3D/barrel.xpm
C 161,216,240


1111111111
1000000001
1000000001
10000S0001
1000000001
1000020001
1000000001
1111111111
