NO ./textures/wolf3D/wood.xpm
R 					1240 680
F 255,150,0
SO ./textures/wolf3D/greystone.xpm
WE ./textures/wolf3D/redbrick.xpm
EA ./textures/wolf3D/purplestone.xpm
S ./textures/wolf3D/barrel.xpm
C 0,255,255



        1111
        1001
111111111001111111111111
100000000000000000000011
100000000000000000000011
10000000000000000S000011
100000000000000000000011
100000000000000000000001111
111110000000000000000000001
111111110011110000000011111
1000100000000100000000111
1111100010100100000000001
1000100000000100000000111
10001000000001000200001
10001100000111002000001
10000111111100000200001
10000000000000000000001
10000000000000000000001
10000000010000000000001
10000000010000000000001
11111111110000000000001
10002000000000000000001
10000000000000000000001
11111111111111111111111




