NO ./textures/wolf3D/wood.xpm
R 					800 600
F 122,122,122
SO ./textures/wolf3D/greystone.xpm
WE ./textures/wolf3D/redbrick.xpm
EA ./textures/wolf3D/purplestone.xpm
S ./textures/wolf3D/barrel.xpm
C 161,216,240


111111111111111111111111111111111111111111111111111111111111111111111111
100000000000000000000000000000000000000000000000000000000000000000000001
100000000000000000000000000000000000000000000000000000000000000000000001
100000S00000200000000000000000100000000000000000000000000000000000000001
100000000000000000000000000000100000000000000000000000000000000000000001
100000000000000000000000000000100000000000000000000002000000000000000001
100000000000000000000000000000100000000000000000000000000000000000000001
100000000000000000000000000000100000000000000000000000000000000000000001
100000000000000000000000000000000000000000000000000000000000000000000001
100000000000000000000000000000000000000000000000000000000000000000000001
100000000000000000000000000000000000000000000000000000000000000000000001
100000000000000000000000000000000000000000000000000000000000000000000001
100000000000000000000000000000000000000000000000000000000000000000000001
100000000000000000000000000000000000000000000000000000000000000000000001
111111111111111111111111111111111111111111111111111111111111111111111111
