NO ./textures/wolf3D/wood.xpm
R 					1240 680
F 255,150,0
SO ./textures/wolf3D/greystone.xpm
WE ./textures/wolf3D/redbrick.xpm
EA ./textures/wolf3D/purplestone.xpm
S ./textures/wolf3D/barrel.xpm
C 0,255,255


111111
100001
100001
1000W1
111111
