NO ./textures/wolf3D/wood.xpm
R 					1240 800
F 122,122,122
SO ./textures/wolf3D/mossy.xpm
WE ./textures/wolf3D/eagle.xpm
EA ./textures/wolf3D/purplestone.xpm
S ./textures/wolf3D/barrel.xpm
C 161,216,240


1111111111111111        1111111111111111
1000000000000001        1000000000000001
1000000000000001        1000000000000001
1000000000000001        1000000000000001
1000000000000001111111111000000000000001
100000N000000000000000000000000000000001
1000000000000001111111111000000000000001
1000000000000001        1000000000000001
1111110000011111        1111111111111111
     1000001
     1000001
     1000001
     1111111
