R 1080 760
NO ./textures/wolf3D/eagle.xpm
SO ./textures/wolf3D/mossy.xpm
EA ./textures/wolf3D/greystone.xpm
WE ./textures/wolf3D/wood.xpm
S ./textures/wolf3D/barrel.xpm
C 255,0,255
F 0,255,0

11111111111111111
100000000000000011111111111111
102000002000002000000000000001
100000000000000011111111111001
100020002000200000000000000001
100000000000000000000000000001
10202020N020202011111111011111    111
10000000000000001      101        121
10002000200200001      101        101
1000000000000000111111110111111111101
1020000020000200000000000000000002001
1111111110000000111111110000001111111
        111111111      11111111
