R            1080 760
NO ./textures/wolf3D/eagle.xpm
SO ./textures/wolf3D/mossy.xpm
WE ./textures/wolf3D/wood.xpm
EA ./textures/wolf3D/greystone.xpm
S ./textures/wolf3D/barrel.xpm
F 0,255,0
C 255,0,255

11111111111111111
100000000000000011111111111111
100000000000000000000000000001
100000000000000011111111111001
100000000000000000000000000001
100000000000000000000000000001
10000000N000000011111111011111
10000000000000001      101
10000000000000001      101
11111111111111111      111
