R 1080 600
C 225,30,0
NO ./textures/wolf3D/eagle.xpm
SO ./textures/wolf3D/mossy.xpm
EA ./textures/wolf3D/greystone.xpm
WE ./textures/wolf3D/wood.xpm
S ./textures/wolf3D/greenlight.xpm
F 220,100,0

111111111111111111
100000000000000001
100000000000000001
100000000000000001
100000000S00000001
100000000000000001
100000000000000001
100000000000000001
100000000000000001
111111111111111111

