                                                                                                                                                                                                                                                                                                                                                                                                                                                                                                                                                                                                                                                                                                                                                                                                                                                            WE                                                                                                                   ./textures/wolf3D/mossy.xpm
                                                                                                                                                                                                                                                                                                                                                                                                                                                                                                                                                                                                                                                                                                                                                                                                                                                        
                                                                                                                                                                                                                                                                                                                                                                                                                                                                                                                                                                                                                                                                                                                                                                                                                                                                    SO                                                                         ./textures/wolf3D/colorstone.xpm
                                                                                                                                                                                                                                                                                                                                                                                                                                                                                                                                                                                                                                                                                                                                                                                                                                                                             F                                  122                    ,                       122,                    122
                                                                                                                                                                                                                                                                                                                                                                                                                                                                                                                                                                                                                                                                                                                                                                                                                                                                                        NO                                                                             ./textures/wolf3D/greystone.xpm
                                                                                                                                                                                                                                                                                                                                                                                                                                                                                                                                                                                                                                                                                                                                                                                                                                                            S                                                           ./textures/wolf3D/greenlight.xpm
                                                                                                                                                                                                                                                                                                                                                                                                                                                                                                                                                                                                                                                                                                                                                                                                                                                                                                                           R                                                     1080                  720
                                                                                                                                                                                                                                                                                                                                                                                                                                                                                                                                                                                                                                                                                                                                                                                                                                                                                                                                     EA                                                                                           ./textures/wolf3D/eagle.xpm
                                                                                                                                                                                                                                                                                                                                                                                                                                                                                                                                                                                                                                                                                                                                                                                                                                                        
                                                                                                                                                                                                                                                                                                                                                                                                                                                                                                                                                                                                                                                                                                                                                                                                                                                                                 C                                           255                                                                                            ,200,160
11111111111111111
100000000000000011111111111
102000002000102000000000001
100000000000100011111111101
11111100201110001       101
10000100000010001       101
10202120W02010201       101111
10000100000010001       100001
10002111111111001       111111
10000100000000001
10200110201111111
10000000000000001
11111111111111111
