R 1040 760
NO ./textures/wolf3D/colorstone.xpm
SO ./textures/wolf3D/purplestone.xpm
EA ./textures/wolf3D/redbrick.xpm
WE ./textures/wolf3D/bluestone.xpm
S ./textures/wolf3D/pillar.xpm
C 255,0,255
F 0,255,0

11111111111111111
100000000000000011111111111111
102000002000002000000000000001
100000000000000011111111111001
100020002000200000000000000001
100000000000000000000000000001
102020200020202011111111011111    111
10000000000000001      101        121
10002000200200001      101        101
10000000000000001      10111111111101
10200000200002001      10000000002001
1000N000000000001      10000001111111
11111111111111111      11111111
